111111111111111111111111
10000E000000000000C00CP1
111111111111111111111111