1111111111
1C00000001
1011100001
1000001101
110PCE11C1
1111111111