1111111
11C1001
1011001
10010E1
1P00001
1111111